................................................................
................................................................
............................................................K...
................................................................
................................................................
..........#####################.................................
..........#...................#.................................
..........#...................#..................H..............
..........#........T..........#.................................
..........#...................#...T.............................
......T...#...................#.................................
..........#...................#.................................
..........M...................#.................................
..........#...................#....................T............
..........#...................#.................................
..........#...................M################################E
..........#...................#.................................
..........#...............T...#.................................
S################.............#.............T..............T....
................#.............#.................................
................#.............#...T.............................
.......T........#.............#.................................
................#.............#.................................
................#.............#.................................
....#############.............#.................................
....#.....................T...#.................................
....#.........................#.................................
....#....T....................#.................................
....#.........................#.................................
....#.........................#.................................
....###########################.................................
................................................................
................................................................
.....T............T.............................................
................................................................
................................................................
