...........T...................S
...............................#
...............................#
...............................#
.......................T.......#
.......................#MMM#####
.......................#........
........T..............#........
........################........
........#..............T........
........#.......................
........#MMM####................
...............#................
...............#...T............
...............#...######E......
...............#...#............
...............#MMM#............
................................
