................................................................
................................................................
....................T.......................................K...
................................................................
................................................................
..........#####################.................................
..........#...................#.................................
..........#...................#.................................
..........#...................#.................................
..........#...................#.................................
..........#..T................#.................................
..........#...................#.................................
..........M...................#.................................
..........#...................#.................................
..........#...................#.................................
..........#...................M...................#############E
..........#...................#...................#.............
..........#...................#...................#.............
S##########...................#...................#.........T...
..............................#...................#.............
..............................#...................#..T..........
..............................#...................#.............
..............................#...................#.............
..............................#...................#.............
..............................#...................#.............
...........................T..#...................M.............
..............................#...................#.............
..............................#...................#.............
..............................#...................#.............
..............................#...................#.............
..............................##########M##########.............
................................................................
................................................................
........................................T.......................
................................................................
................................................................
